############################################B######################
###########                ################# ######### ############
########################## ################# ######### ############
################           ###############   #########  ########  #
########################## #################   ######## ########  #
#########################                                         #
A                         #########################################           
###################################################################