#####B#########
##### #########
####         ##
############ ##
############ ## 
############ ##
A            ##
###############