###########
#         #
# ####### #
# ###     #
# ### #####
# ###     #
# ####### #
# ####### #
# ####### #
# ####### #
# ####### #
#A#######B#
###########   